14 14 14 14 14 14 14 14 14 14 14 14 14 14 14 14 14 14 14 14 14 14 14 14 14 14 14 14 14 14 14 14 14 14 14 14 14 14 14 14 14 14 14 14 14 14 14 14 14 14
14 14 14 14 14 14 14 14 14 14 14 14 14 14 14 14 14 14 14 14 14 14 14 14 14 14 14 14 14 14 14 14 14 14 14 14 14 14 14 14 14 14 14 14 14 14 14 14 14 14
14 14 14 14 14 14 14 14 14 14 14 14 14 2 2 2 2 2 14 14 14 2 2 2 2 14 14 14 2 2 2 2 14 14 14 14 14 14 2 2 2 2 14 14 14 14 14 14 14 14
14 14 14 14 14 14 14 14 14 14 14 14 14 14 14 14 14 14 14 14 2 2 2 2 14 14 14 2 2 2 2 14 14 14 14 2 2 2 2 14 14 14 14 14 14 14 14 14 14 14
14 14 14 14 14 14 14 14 14 14 14 14 14 14 19 11 11 11 11 11 11 11 11 11 11 11 11 11 11 11 11 11 22 2 2 14 2 2 14 2 19 11 11 22 14 14 14 14 14 14
14 14 14 14 14 14 14 14 14 14 14 14 2 14 10 4 4 4 4 4 4 4 4 4 4 4 4 4 4 4 4 4 16 22 2 2 2 2 2 19 13 4 4 9 14 14 14 14 14 14 
14 14 14 14 14 14 14 14 14 14 14 2 14 2 10 4 4 4 4 4 4 4 4 4 4 4 4 4 4 4 4 4 4 16 11 11 11 11 11 13 4 4 4 9 2 2 2 2 14 14
14 14 14 14 14 14 14 14 14 14 14 14 14 2 10 4 0 0 0 6 0 0 7 0 4 4 4 4 4 4 4 4 4 4 4 4 4 4 4 4 4 4 4 9 14 14 14 14 14 14
14 14 14 14 14 14 14 2 14 2 14 2 2 14 10 4 0 12 8 8 8 8 8 8 8 8 8 8 8 8 18 4 4 4 4 4 4 4 4 4 4 4 4 9 2 2 2 2 14 14 
14 14 2 14 2 2 19 11 11 11 11 11 11 11 13 4 0 9 2 2 14 2 14 2 2 14 2 2 14 2 10 4 4 4 4 4 4 4 4 4 4 4 4 9 2 2 2 2 14 14 
14 14 14 14 14 14 10 4 4 4 4 4 4 4 4 6 6 9 2 2 14 2 2 14 14 2 2 2 14 2 10 4 4 4 4 28 24 24 24 24 24 27 4 9 14 14 14 14 14 14 
14 14 2 14 2 14 10 4 4 4 4 4 4 4 4 7 6 9 2 2 2 14 14 2 2 14 2 2 14 2 10 4 4 4 4 29 17 17 17 17 17 26 4 16 22 2 2 2 14 14 
14 14 14 14 14 2 10 4 1 1 1 1 1 4 4 6 0 16 11 11 11 11 11 11 11 11 11 11 11 11 13 4 6 28 24 17 17 17 17 17 25 4 4 6 16 22 2 2 14 14 
14 14 14 14 14 2 10 4 1 3 3 3 1 4 4 6 7 0 0 7 0 6 6 7 0 7 0 6 7 4 4 4 4 29 17 17 17 17 17 17 25 4 4 7 4 9 2 2 14 14 
14 14 14 2 14 14 10 4 1 3 3 3 1 4 4 4 4 7 0 6 6 0 0 0 6 0 6 7 4 4 4 4 4 30 17 17 17 17 17 17 17 27 4 0 0 9 2 2 14 14 
14 14 14 14 14 14 10 4 1 3 3 3 1 4 4 4 4 4 4 6 6 6 0 0 7 6 0 6 4 4 4 4 4 4 29 17 17 17 17 17 17 25 4 4 4 9 14 14 14 14 
14 14 14 2 14 2 10 4 1 3 3 3 1 4 4 4 4 4 4 4 6 6 0 5 6 6 7 4 4 4 4 4 4 4 29 17 17 17 17 17 17 25 4 4 12 21 14 14 14 14 
14 14 14 14 14 14 10 4 1 1 0 1 1 4 4 4 4 4 4 4 4 6 6 5 0 6 4 4 4 4 4 4 4 4 30 17 17 17 17 17 17 26 4 12 21 2 2 2 14 14 
14 14 14 14 14 2 10 0 6 7 0 4 4 4 4 4 4 4 4 4 4 4 6 5 6 4 4 4 4 4 4 4 4 4 4 30 23 23 17 23 26 4 4 9 2 2 2 2 14 14 
14 14 14 2 14 2 10 4 4 4 0 4 4 4 4 4 4 4 4 4 4 4 0 5 0 4 4 4 4 4 4 4 4 4 4 4 4 4 5 0 4 4 4 9 2 2 2 2 14 14 
14 14 14 2 2 2 10 4 4 4 0 4 4 4 4 4 4 4 4 4 4 4 6 5 0 4 4 4 4 4 4 4 4 4 4 4 4 4 5 4 4 4 4 9 14 14 14 14 14 14 
14 14 14 14 14 14 10 4 4 4 0 4 4 4 4 4 4 4 4 4 4 4 6 5 6 4 4 4 4 4 4 4 4 4 4 4 4 4 5 4 4 4 12 21 2 2 2 2 14 14 
14 14 14 14 2 14 10 4 0 0 0 4 4 4 4 4 4 4 4 4 4 4 7 5 6 4 4 4 4 4 4 4 4 4 4 4 4 7 5 4 4 4 9 2 14 14 14 14 14 14 
14 14 14 14 14 14 10 4 0 4 4 4 4 4 4 4 4 4 4 4 4 4 6 5 6 4 4 4 4 4 4 4 4 4 4 4 4 6 5 6 4 4 9 2 2 2 2 2 14 14 
14 14 14 14 2 2 10 4 0 4 4 4 4 4 0 0 0 6 6 6 4 4 0 5 0 4 4 4 4 4 4 4 4 4 4 6 28 15 26 4 4 4 9 2 14 14 14 14 14 14 
14 14 14 14 14 14 10 4 0 4 4 4 4 4 4 7 0 0 0 0 0 0 6 5 7 0 4 4 4 4 4 4 4 4 4 6 5 0 4 4 4 4 16 22 2 2 2 2 14 14 
14 14 14 14 14 2 10 4 0 4 4 4 4 4 6 0 0 7 6 6 7 6 6 5 6 6 6 0 6 6 6 0 0 0 0 6 5 0 4 4 4 4 4 9 14 14 14 14 14 14 
14 14 14 2 2 2 10 4 0 4 4 6 15 15 15 15 15 15 15 15 15 15 15 17 15 15 15 15 15 15 15 15 15 15 15 15 25 4 4 4 4 4 4 9 14 14 14 14 14 14
14 14 14 14 14 14 10 4 0 4 4 4 0 7 0 0 0 0 0 6 6 6 6 5 6 6 6 4 4 6 6 4 4 4 4 4 5 0 4 4 4 4 4 9 14 14 14 14 14 14 
14 14 14 14 14 2 10 4 0 4 4 4 0 7 0 0 0 0 0 0 6 0 6 5 6 0 4 4 4 4 4 4 4 4 4 4 5 7 4 4 4 4 4 9 14 14 14 14 14 14 
14 14 2 14 2 2 10 4 0 4 4 4 0 4 4 4 4 4 4 4 4 4 7 5 6 6 4 4 4 4 4 4 4 4 4 4 5 0 4 4 4 4 4 9 2 2 14 14 14 14 
14 14 14 14 14 14 10 4 0 4 4 4 0 0 0 4 4 4 4 4 4 0 0 5 0 6 4 4 4 0 0 0 4 4 4 4 5 7 4 4 4 4 4 9 14 14 14 14 14 14 
14 14 14 14 14 14 10 4 0 4 4 4 4 4 0 4 4 4 4 4 4 4 0 5 7 6 4 4 4 6 6 4 4 4 4 4 5 0 4 4 4 4 4 9 2 2 2 2 14 14 
14 14 14 14 14 14 10 4 0 4 4 4 4 4 6 4 4 4 4 4 4 4 6 5 0 4 4 0 4 4 4 6 4 4 4 0 5 6 4 4 4 4 4 9 14 14 14 14 14 14 
14 14 14 14 14 14 10 4 0 4 4 4 4 4 6 4 4 4 4 4 4 4 6 5 0 4 4 4 4 4 0 4 4 4 4 4 5 0 4 4 4 4 4 9 2 14 14 14 14 14 
14 14 14 14 14 14 10 4 0 0 7 0 6 6 0 4 4 4 4 4 4 4 0 5 6 0 4 4 4 4 0 4 4 4 4 4 5 0 4 4 4 4 4 9 2 2 2 2 14 14 
14 14 14 14 19 11 13 4 6 6 0 6 0 0 0 4 4 4 4 4 4 0 0 5 0 6 0 4 4 4 4 4 4 4 4 4 6 6 4 4 4 4 4 9 14 14 14 14 14 14 
14 14 14 14 10 7 0 4 0 0 0 0 7 0 0 4 4 4 4 0 0 0 7 5 6 0 7 6 6 4 4 4 4 4 4 0 0 0 4 4 4 4 4 9 2 2 2 2 14 14 
14 14 14 14 10 0 4 4 6 7 6 0 0 0 0 4 4 4 4 6 0 7 0 5 7 6 0 0 6 4 4 4 4 4 4 6 0 4 4 4 4 4 4 9 14 14 14 14 14 14 
14 14 14 14 10 4 4 6 0 0 0 0 0 6 0 4 4 4 0 0 0 0 7 5 0 6 0 0 0 6 4 4 4 4 4 6 0 4 4 4 4 4 4 9 14 14 14 14 14 14 
14 14 14 14 20 18 0 4 0 6 0 6 6 0 0 4 0 6 0 6 0 0 0 5 6 6 7 4 6 4 4 4 4 4 4 0 0 4 4 4 4 4 4 9 2 2 2 2 14 14 
14 14 14 14 14 20 18 4 4 4 4 4 4 4 4 7 0 7 0 0 0 0 6 5 6 7 0 7 6 4 4 4 4 4 4 6 0 0 4 4 4 4 4 9 14 14 14 14 14 14 
14 14 14 14 14 14 10 4 4 4 4 4 4 4 6 6 6 0 7 0 0 0 6 0 0 0 0 4 4 4 4 4 4 4 0 0 7 0 0 4 4 4 4 9 14 2 2 2 2 14 
14 14 14 14 14 14 10 6 7 0 0 7 0 12 8 8 8 8 8 18 0 0 6 7 0 0 7 0 0 7 0 6 6 0 0 7 0 0 0 4 4 4 4 9 14 14 14 14 14 14 
14 14 14 14 14 14 20 8 8 8 8 8 8 21 2 2 2 2 2 20 8 8 8 8 8 8 8 8 8 18 4 4 4 4 12 8 8 8 8 8 8 8 8 21 14 14 14 14 14 14 14 14 14 
14 14 14 14 14 14 2 14 2 14 2 2 2 14 14 14 2 2 2 2 2 14 14 14 2 2 2 2 2 20 8 8 8 8 21 14 14 14 2 2 2 2 14 14 14 14 14 14 14 14
14 14 14 14 14 14 14 14 14 14 14 14 2 2 2 2 14 14 14 14 14 14 14 14 14 14 14 14 2 2 2 2 14 14 14 14 14 14 2 2 2 2 14 14 14 14 14 14 14 14
14 14 14 14 14 14 14 14 2 14 2 14 2 14 2 2 2 2 14 14 2 2 2 14 2 2 2 2 14 14 2 2 2 2 14 14 2 2 2 2 14 14 14 14 14 14 14 14 14 14
14 14 14 14 14 14 14 14 14 14 14 14 14 14 14 14 14 2 2 14 14 14 14 14 2 2 2 2 14 14 14 14 14 14 14 14 14 14 14 14 14 14 14 14 14 14 14 14 14 14
14 14 14 14 14 14 14 14 14 14 14 14 14 14 14 14 14 14 14 14 14 14 14 14 14 14 14 14 14 14 14 14 14 14 14 14 14 14 14 14 14 14 14 14 14 14 14 14 14 14